15 15
001100011011011
000001000000011
101101110010100
100100000110001
110001110000111
100100010110001
001011110011000
101011011001011
100010010011010
100111000110000
110011010000111
000100011010100
010101010010000
110101010110101
000011000100000
